NNNNNNNNNNNNNNNNNNNNNNNNNNNNNNNNNN
NNNNNNNNNNNNNNNNNNNNNNNNNNNNNNNNNN
NNNNNNNNNNNNNNNNNNNNNNNNNNNNNNNNNN
NNNNNNN然然然然然然然然 NNNNNNNNNN
NNNNNNN>               <NNNNNNNNNN
NNNNNNNM a  b      e   MNNNNNNNNNN
NNNNNNN>               <NNNNNNNNNN
NNNNNNNM               MNNNNNNNNNN
NNNNNNN>           d   <NNNNNNNNNN
NNNNNNNM    c          MNNNNNNNNNN
NNNNNNN>               <NNNNNNNNNN
NNNNNNNM^M^M^M^M ^M^M^MMNNNNNNNNNN
NNNNNNNNNNNNNNNN1NNNNNNNNNNNNNNNNN
NNNNNNNNNNNNNNNNNNNNNNNNNNNNNNNNNN
NNNNNNNNNNNNNNNNNNNNNNNNNNNNNNNNNN
NNNNNNNNNNNNNNNNNNNNNNNNNNNNNNNNNN
NNNNNNNNNNNNNNNNNNNNNNNNNNNNNNNNNN
NNNNNNNNNNNNNNNNNNNNNNNNNNNNNNNNNN