NNNNNNNNNNNNNNNNNNNNNNNNNNNNNNNNNN
NNNNNNNNNNNNNNNNNNNNNNNNNNNNNNNNNN
NNNNNNNNNNNNNNNNNNNNNNNNNNNNNNNNNN
NNNNNNN;M;M;M;M;M;M;M;M NNNNNNNNNN
NNNNNNN>               <NNNNNNNNNN
NNNNNNNM  p        t   MNNNNNNNNNN
NNNNNNN>               <NNNNNNNNNN
NNNNNNNM    u    q     MNNNNNNNNNN
NNNNNNN>               <NNNNNNNNNN
NNNNNNNM  r       s    MNNNNNNNNNN
NNNNNNN>               <NNNNNNNNNN
NNNNNNNM^M^M^M^M1^M^M^MMNNNNNNNNNN
NNNNNNNNNNNNNNNNNNNNNNNNNNNNNNNNNN
NNNNNNNNNNNNNNNNNNNNNNNNNNNNNNNNNN
NNNNNNNNNNNNNNNNNNNNNNNNNNNNNNNNNN
NNNNNNNNNNNNNNNNNNNNNNNNNNNNNNNNNN
NNNNNNNNNNNNNNNNNNNNNNNNNNNNNNNNNN
NNNNNNNNNNNNNNNNNNNNNNNNNNNNNNNNNN
