NNNNNNNNNNNNNNNNNNNNNNNNNNNNNNNNNN
NNNNNNNNNNNNNNNNNNNNNNNNNNNNNNNNNN
NNNNNNNNNNNNNNNNNNNNNNNNNNNNNNNNNN
NNNNNNN;M;M;M;M;M;M;M;M NNNNNNNNNN
NNNNNNN>               <NNNNNNNNNN
NNNNNNNM  k            MNNNNNNNNNN
NNNNNNN>          l    <NNNNNNNNNN
NNNNNNNM               MNNNNNNNNNN
NNNNNNN>  m   n        <NNNNNNNNNN
NNNNNNNM               MNNNNNNNNNN
NNNNNNN>               <NNNNNNNNNN
NNNNNNNM^M^M^M^M ^M^M^MMNNNNNNNNNN
NNNNNNNNNNNNNNNN1NNNNNNNNNNNNNNNNN
NNNNNNNNNNNNNNNNNNNNNNNNNNNNNNNNNN
NNNNNNNNNNNNNNNNNNNNNNNNNNNNNNNNNN
NNNNNNNNNNNNNNNNNNNNNNNNNNNNNNNNNN
NNNNNNNNNNNNNNNNNNNNNNNNNNNNNNNNNN
NNNNNNNNNNNNNNNNNNNNNNNNNNNNNNNNNN
