MMMMMMMMMMMMMMMM3MMMMMMMMMMMMM M
M                              M
M    FMMMM    }        FMMMM   M
M    MMMMM             MMMMM   M
M    MMMMM             MMMMM   A
4    MMMMM             MMMMM   A
M    MM-MM      }      MMM&M   A
M                              A
M   }                   FMMMM  A
M                       MMMMM  A
M                       MMMMM  A
M       Z          }    MMMMM  M
M        MMMM           MM(MM  M
M        MMMM                  2
M        MMMM                  M
M                       }      M
M                              M
MMMMMMMMMMMMMMMMMMMMMMMMMMMMMMMM
