XXXXXXXXXXXXXXXXXXXXXXXXXXXXXXXX
XNNNNNNNNNNNNNNNNNNNNNNNNNNNNNNX
XNNNNNNNNNNNNNNNNNNNNNNNNNNNNNNX
XNNNN                 i   NNNNNX
X   TMTMTMTMTMTMTMTMTMTMTM     X
X            g                 X
X     H H      H H             X
X     M M      M M      >M<M   X
X     ^ ^      ^ ^      >M<M   X
X     M M      M M             X
X                              1
X   L    Lh   L    L     L     X
X f L    L    L    L  o  L     X
X   L    L    L    L     L     X
XNNNNNNNNNNNNNNNNNNNNNNNNNNNNNNX
XNNNNNNNNNNNNNNNNNNNNNNNNNNNNNNX
XNNNNNNNNNNNNNNNNNNNNNNNNNNNNNNX
XXXXXXXXXXXXXXXXXXXXXXXXXXXXXXXX