MMMMMMMMMMMMMMMM6MMMMMMMMMMMMMMM 
M                              M
M                              M
M                              M
M            TMM               1
M    TMM              TMM      M
M                              M
M                              M
7                              M
M                              M
DDDDDDDDDDD8DDDDDDDDD          M
DDDDDDDDDDDDDDDDDDDDD          M
DDDDDDDDDDDDDDDDDDDDD          M
DDDDDDDDDDDDDDDDDDDDD          M
DDDDDDDDDDDDDDDDDDDDD          M
DDDDDDDDDDDDDDDDDDDDD          M
DDDDDDDDDDDDDDDDDDDDD          M
DDDDDDDDDDDDDDDDDDDDDTMMTMMTMMTM