XXXXXXXXXXXXXXXXXXXXXXXXXXXX@XXX
X CCCCCCCCCCCCC                X
X                      TMM     X
X               TMM            X
X                              X
X                              X
X                    TMM       X
X   TMM                        X
X                              X
9                              X
X                   TMM        X
X                              X
NNNNNNNNNNNNNN4NNNNNNNNNNNNNNNNN
NNNNNNNNNNNNNNNNNNNNNNNNNNNNNNNN
NNNNNNNNNNNNNNNNNNNNNNNNNNNNNNNN
NNNNNNNNNNNNNNNNNNNNNNNNNNNNNNNN
NNNNNNNNNNNNNNNNNNNNNNNNNNNNNNNN
NNNNNNNNNNNNNNNNNNNNNNNNNNNNNNNN
