XXXXXXXXXXXXXXXXXXXXXXXXXXXXXXXX
X> j <XNNNNNNNNNNNNNNNNNNNNNNNNX
X     XNNNNNNNNNNNNNNNNNNNNNNNNX
X>   <XNNNNNNNNNNNNNNNNNNNNNNNNX
X     XNNNNNNNNNNNNNNNNXXXXXXXXX
X>   <XNNNNNNNNNNNNNNNNXNNNNNNNX
X     XXXXXXXXXXXXXXXXNXNNNNNNNX
X>   <XWXWXWXWXWXWXWXWXXNNNNNNNX
X     XMXMXMXMXMXMXMXMXXNNNNNNNX
X                      XXX@XXXXX
X                              4
XXXXXXXXXXXXXXXXXXXXXXXXXXXXXXXX
XNNNNNNNNNNNNNNNNNNNNNNNNNNNNNNX
XNNNNNNNNNNNNNNNNNNNNNNNNNNNNNNX
XNNNNNNNNNNNNNNNNNNNNNNNNNNNNNNX
XNNNNNNNNNNNNNNNNNNNNNNNNNNNNNNX
XNNNNNNNNNNNNNNNNNNNNNNNNNNNNNNX
XXXXXXXXXXXXXXXXXXXXXXXXXXXXXXXX