XXXXXXXXXXXXXXXXXXXXXXXXXXXXXXXX
XGGGGGGGGGGGGGGGGGGGGGGGGGGGGGGX
XGGGGGGGGGGGGGGGGGGGGGGGGGGGGGGX
X                4           GGX
X                            GGX
X  Z                         GGX
X    MMMM                    GGX
X    MMMM                    GGX
X    MMMM                    GGX
X    MMMM                    GGX
X    MMMM                    GGX
X                            GGX
X                            GGX
X                            GGX
X                            GGX
XGGGGGGGGGGGGGGGGGGGGGGGGGGGGGGX
XGGGGGGGGGGGGGGGGGGGGGGGGGGGGGGX
XXXXXXXXXXXXXXXXXXXXXXXXXXXXXXXX
