XMMMMMMMMMMMMMMMMMMMMMMMMMMMMMMX
X                              X
XBMMM                          X
XMMMM                          6
XMMMM                          X
XM_MM        XXXXXXXXXXXXXXXXXXX
X            XNNNNNNNNNNNNNNNNNX
XBMMM        XNNNNNNNNNNNNNNNNNX
XMMMM        XNNNNNNNNNNNNNNNNNX
XMMMM        XNNNNNNNNNNNNNNNNNX
XMMMM        XNNNNNNNNNNNNNNNNNX
X            XNNNNNNNNNNNNNNNNNX
XBMMM        XNNNNNNNNNNNNNNNNNX
XMMMM        XNNNNNNNNNNNNNNNNNX
XMMMM        XNNNNNNNNNNNNNNNNNX
XMMMM        XNNNNNNNNNNNNNNNNNX
X            XNNNNNNNNNNNNNNNNNX
XMMMMMMMMMMMMXNNNNNNNNNNNNNNNNNX
