XXXXXXXXXXXXXXXXXXXXXXXXXXXXXXXX
XNNNNNNNNNNNNNNNNNNNNNNNNNNNNNNX
XNNNNNNNNNNNNNNNNNNNNNNNNNNNNNNX
XNNNNNNNNNNNNNNNNNNNNNNNNNNNNNNX
XNNNNNNNNNNNNNNNNNNNNNNNNNNNNNNX
XNN        w                 NNX
XNN  TMM       µ       TMM   NNX
XNN                          NNX
XNN                          NNX
XNN  TMM               TMM   NNX
XNN                          NNX
XNN  TMM               TMM   NNX
XNN                          NNX
XNNNNNNNNNNNNNN9NNNNNNNNNNNNNNNX
XNNNNNNNNNNNNNNNNNNNNNNNNNNNNNNX
XNNNNNNNNNNNNNNNNNNNNNNNNNNNNNNX
XNNNNNNNNNNNNNNNNNNNNNNNNNNNNNNX
XXXXXXXXXXXXXXXXXXXXXXXXXXXXXXXX
